7 5 3 4
1 1 1 1 1
0 0 0 0 2
1 1 1 1 1
0 0 0 0 0
0 0 0 0 3
0 0 0 0 3
3 3 3 4 3
4 4
4 5
4 6
3 4 4 4
4 6 2