10 10 3 4
1 1 1 1 1 1 1 1 1 1
0 0 0 0 2 2 2 2 2 2
1 1 1 1 1 3 1 2 3 2
0 0 0 0 0 0 1 1 2 3
0 0 0 0 3 3 2 1 2 3
0 0 0 0 3 2 1 1 1 1
3 3 3 4 3 2 2 1 2 3
0 0 0 0 0 0 1 1 2 3
0 0 0 0 3 3 2 1 2 3
0 0 0 0 3 2 1 1 1 1
4 4
4 5
4 6
3 4 4 4
4 6 2
